#####################
#...#...#...........#
#.#...#.#.#######.#.#
#.#####.#.#.....#.###
#.#...#...#..##.#...#
#.#.#.#.####..#####.#
#...#.#.#.....#...#.#
#####.#.#.#####.#.#.#
#...#.#.#.#.....#...#
###.#.###.###.#######
#...#.....#...#.....#
###.#.#####.###.###.#
#.#.#.#...#.......#.#
#.#.###.#.#########.#
#.#.#...#......#....#
#.#...########.#.####
#...#.#......#...#..#
#.#.######.#.#####..#
#.#........#.......@#
#####################