###############################
#.#.................#.........#
#.#.###########.###.#.#####.#.#
#.#.#.....#.....#...#.....#.#.#
#.#.#.###.#.#######.#####.#.#.#
#...#.#...#.......#.#...#.#.#.#
#.###.#.###.#####.###.#.#.#.#.#
#...#.#.#.......#.#...#...#.#.#
###.#.#.#########.#.#######.#.#
#.#.#.#...........#.....#.#.#.#
#.#.#.#######.#########.#.#.###
#...#.....#.#.#...#.......#...#
#.#####.#.#.#.#.#.#.#########.#
#.#.#.#.#.#...#.#.....#.....#.#
#.#.#.#.#.#####.#######.###.#.#
#...#.#.#.......#.....#.#...#.#
#####.#.#########.###.#.#.###.#
#.....#.#.......#.#...#.#.....#
#.#####.#.#####.#.#.###.#####.#
#.#.....#...#...#.#.....#...#.#
#.#########.#.###.#######.#.#.#
#.#.........#...#...#.....#.#.#
#.#.###########.###.#.#####.#.#
#.#...#.......#...#.#.....#.#.#
#.###.#.#####.###.#.#.###.###.#
#.....#.#...#...#...#.#.#.....#
#######.#.#.#.#.#####.#.#######
#.#.....#.#.#.#.....#.#.....#.#
#.#.#####.#.#.#######.#.###.#.#
#@........#.#...........#.....#
###############################